00000100000
00000100000
00101111100
00101111100
00101111100
11101111100
00111111100
00111111100
00111111100
00000000000
00000000000

Wall
Floor