00000100000
00000100000
00101111100
00101111100
00101111100
00101111100
00111111100
00111111100
00111111100
00000100000
00000100000

Wall
Floor