00001000000
00001000000
00111111100
00111111100
00111010100
00111010100
00100010000
00111111111
00111111100
00000000000
00000000000

Wall
Floor