00000100000
00000100000
00111111100
00111111100
00111111100
00111111100
00111100000
00111111111
00111111100
00000000000
00000000000

Wall
Floor