00000000000
00000000000
00111111100
00111000000
00111111100
00111111100
00111111100
00111111100
00111111100
00000100000
00000100000

Wall
Floor