00000010000
00000010000
00111111100
00111111100
00110000100
00111111100
00110111111
00110111100
00110111100
00000010000
00000010000

Wall 
Floor
