00000000000
00000000000
00111111100
00110001100
00101111111
00101011100
11111011100
00111011100
00111011100
00000010000
00000010000

Wall
Floor
