00000100000
00000100000
00111111100
00111111100
11111111100
00101111100
00101111100
00111001100
00111011100
00000001000
00000001000

Wall
Floor