00000000000
00000000000
00111111100
00110100000
00001111100
00111111111
11111111000
00111101100
00111101100
00000000100
00000000100

Wall
Floor