00000100000
00000100000
00111111100
00111111100
00100100111
00111110100
00111111100
00110011100
00111011100
00001000000
00001000000

Wall
Floor
