00000100000
00000100000
00111111100
00111111100
00100010111
00111111100
00111111100
00111011100
00111011100
00001000000
00001000000

Wall
Floor
