00001000000
00001000000
00111111100
00111111100
00100111111
00111110100
00101110100
00101111100
00101111100
00000010000
00000010000

Wall
Floor
