00000000000
00000000000
00111111100
11111111111
00111000100
00111111100
00110111100
00110111100
00110111100
00000001000
00000001000

Wall
Floor
