00000000000
00000000000
00111111100
00111111100
00111011111
11111001000
00111011100
00111011100
00111011100
00000000100
00000000100

Wall
Floor