00000100000
00000100000
00111111100
00111101100
00111110000
11111111100
00000111100
00111111100
00111111100
00000000000
00000000000

Wall
Floor