00000000000
00000000000
00111111100
00111111111
00110001100
00110001100
00110011100
00111111100
00111111100
00010000000
00010000000

Wall
Floor
