00000000000
00000000000
00111111100
00111111111
00110001100
00110001100
00110001100
11111111100
00111111100
00000000000
00000000000

Wall
Floor
