00000000000
00000000000
00111111100
00111111100
00110000100
00111111100
00111011111
00111011100
00111011100
00000010000
00000010000

Wall
Floor
