00000000000
00000000000
00111111100
00111111100
00110100000
00111111111
00110111100
00110111100
00110111100
00000100000
00000100000

Wall
Floor